8 8
WWWWWWWW
W....W.W
WW.WW.WW
W....W.W
W.W.WW.E
S.W.WW.W
W......W
WWWWWWWW